224 789 142 585 1071 984 65 263 163 181 850 296 8 828 989 816 840 1058 170 41 
676 1117 342 611 578 48 527 210 10 762 94 796 740 765 546 877 574 365 11 875 
42 689 322 358 831 785 399 891 941 1049 217 654 623 414 89 606 167 339 476 692 
212 962 586 312 813 588 804 321 786 652 324 207 366 262 436 819 901 457 79 351 
338 987 222 397 409 582 1097 171 300 766 949 669 444 620 529 887 516 0 640 827 
1045 636 771 977 1114 810 600 133 308 746 715 20 1121 1033 394 777 581 942 311 85 
284 1039 76 696 40 593 1013 135 175 182 491 520 836 118 294 673 702 354 863 869 
969 63 55 496 561 770 858 265 671 915 1012 269 124 1086 707 412 706 384 691 320 
815 568 1047 880 424 646 997 764 651 315 128 545 998 186 362 550 951 660 47 839 
434 53 1037 944 280 573 876 264 802 845 783 381 920 189 273 492 822 1093 295 383 
200 834 1002 223 287 1027 356 807 1043 69 756 1007 861 198 227 552 1083 1031 1115 281 
626 841 178 370 1104 466 290 1109 395 882 1111 270 446 699 1112 627 423 37 389 477 
914 239 934 488 532 979 112 211 432 782 1042 910 528 340 501 634 1060 357 533 21 
220 921 303 799 448 276 93 458 71 176 817 66 191 484 517 121 62 456 1103 577 
438 84 697 554 747 250 666 604 872 1001 1113 363 277 406 480 1038 152 274 629 960 
279 609 1065 443 499 668 929 282 931 335 594 686 879 426 495 576 753 110 575 148 
693 494 70 159 1122 429 251 670 1 236 767 571 117 844 72 131 199 542 852 541 
1092 801 793 933 1034 196 584 106 243 539 18 203 352 884 1004 1044 1054 229 400 596 
664 637 68 440 437 415 556 97 667 947 138 567 824 60 149 975 558 416 722 86 
104 328 473 605 161 513 1024 553 719 125 544 445 77 524 690 650 393 417 716 731 
136 285 590 763 16 481 46 705 956 725 255 455 659 871 1055 566 249 387 433 1100 
278 935 13 613 913 256 1028 1099 536 6 341 1085 519 81 248 190 522 413 1101 230 
866 820 54 506 665 242 638 1076 319 909 531 204 924 649 980 614 846 202 309 420 
1084 233 888 331 893 982 298 1048 164 398 1108 663 1094 157 698 1035 635 57 333 555 
683 957 761 232 379 38 169 271 185 272 856 30 749 1068 868 123 505 450 221 306 
526 518 607 475 795 1010 894 241 468 336 1067 583 127 134 643 948 288 158 376 712 
653 530 1025 310 624 925 332 835 108 559 258 391 641 234 599 803 1003 1098 111 966 
1075 521 862 91 410 325 657 512 656 51 74 343 798 17 369 1046 293 479 602 784 
493 209 794 364 35 122 318 788 313 675 1066 645 24 154 713 218 681 348 644 709 
961 1051 214 945 392 631 739 33 459 1000 334 750 562 129 168 483 633 811 469 1089 
174 1021 952 565 1052 240 442 28 194 711 730 592 896 299 710 1118 1079 52 330 768 
467 993 44 160 139 741 213 587 355 800 973 1072 64 674 451 1017 231 700 781 867 
955 1074 454 543 253 375 1070 368 580 701 302 695 25 474 187 307 865 201 441 655 
953 471 936 197 748 439 463 808 132 848 1040 679 1105 286 58 359 461 504 954 938 
970 162 297 485 685 1082 548 806 126 192 1026 193 430 572 860 498 502 570 870 401 
940 619 549 45 259 680 1062 165 687 818 515 597 378 684 534 919 32 103 615 718 
922 425 268 617 388 832 1091 337 1030 50 907 971 724 19 244 405 464 31 639 34 
173 431 538 82 305 630 950 22 382 812 744 453 849 146 380 661 1061 115 754 939 
717 823 83 926 15 205 452 1088 903 511 759 959 292 1106 560 326 1022 9 608 120 
755 1020 881 988 1015 360 647 905 88 396 814 329 797 1064 107 1056 878 1081 372 723 
246 75 999 503 758 564 864 967 137 508 918 1102 3 36 569 791 603 892 29 235 
579 373 465 188 371 1006 509 721 130 482 729 968 1116 219 735 1018 704 778 407 842 
1005 886 225 141 906 991 1069 1090 682 374 5 92 930 612 995 1036 632 742 80 854 
805 618 1063 752 1123 487 757 625 4 102 150 478 917 470 874 404 737 183 985 180 
226 462 780 344 1009 7 43 390 986 1014 314 708 238 266 745 1110 90 610 727 904 
347 547 385 435 916 56 895 751 958 14 472 59 114 743 1107 291 166 621 859 1019 
421 1050 772 327 500 908 1120 490 857 898 1008 153 419 87 346 428 1041 345 760 937 
976 489 147 963 367 911 688 829 245 965 1077 994 540 1023 787 1057 353 616 978 983 
257 275 143 662 39 252 902 402 773 714 261 1096 228 100 283 523 350 1087 95 447 
843 316 733 140 301 418 1011 974 155 403 932 247 497 779 216 411 591 873 27 172 
105 648 73 589 972 49 946 1080 769 897 427 677 349 736 537 1053 964 179 208 825 
67 678 996 116 923 837 2 738 628 386 792 899 535 598 928 672 267 151 184 889 
449 237 289 990 98 422 658 99 883 728 195 557 601 1119 206 890 156 377 830 144 
833 460 720 927 734 215 595 317 1059 642 838 821 694 109 507 826 726 1032 260 943 
885 853 323 1073 774 775 847 408 119 254 113 703 732 551 1029 851 992 96 981 510 
26 61 101 486 1078 514 809 563 177 855 525 790 912 622 900 776 145 361 12 304 
