208 359 6 14 56 308 344 381 432 337 401 371 76 139 
64 433 111 168 443 118 227 270 100 390 376 442 234 297 
161 411 17 328 276 300 364 242 86 395 1 63 54 207 
28 430 78 66 325 8 4 97 112 152 336 355 416 206 
158 191 11 225 67 113 273 312 187 468 345 368 252 332 
299 5 129 27 43 226 132 117 255 194 307 26 224 383 
77 36 398 127 372 316 154 460 448 128 341 406 452 171 
470 193 62 238 223 41 175 178 304 108 253 9 153 10 
58 428 212 98 396 44 137 219 79 145 246 458 195 286 
240 51 388 385 32 254 7 19 373 202 23 422 277 169 
71 199 30 282 245 453 267 170 384 96 121 174 380 215 
352 375 146 440 287 311 294 413 122 141 250 284 394 73 
476 423 369 342 309 198 68 0 289 232 103 116 290 393 
211 176 259 354 35 33 454 201 295 410 263 459 93 210 
262 343 177 386 57 265 417 391 196 269 424 180 303 61 
156 228 327 216 52 445 106 162 474 142 185 45 320 72 
24 441 331 85 115 164 247 204 292 205 438 437 192 324 
367 478 110 120 405 467 366 151 340 315 29 399 133 75 
47 271 469 301 347 291 314 84 60 188 13 317 356 21 
131 183 144 230 203 209 101 434 42 138 163 365 279 38 
135 200 313 37 306 256 268 283 326 257 378 123 427 296 
221 298 431 404 99 426 274 335 370 25 150 18 318 48 
89 159 420 190 220 82 472 275 167 389 165 261 114 222 
130 59 134 436 189 87 349 321 233 179 249 53 357 125 
119 477 157 280 330 465 55 409 348 464 305 462 435 319 
83 377 358 387 475 149 461 94 34 155 329 235 360 449 
184 346 239 457 148 473 40 236 166 339 102 143 90 439 
350 353 229 20 243 397 338 237 214 197 407 310 403 429 
451 450 361 182 302 260 95 81 281 2 288 65 173 425 
258 147 12 181 264 213 293 334 272 124 80 15 418 455 
471 69 446 109 251 16 392 333 414 379 31 217 140 39 
74 91 50 382 447 136 374 49 160 351 92 278 244 415 
70 421 107 466 444 408 402 362 231 126 285 104 22 88 
172 248 266 241 323 46 419 186 456 363 400 218 3 105 
