317 197 107 1 183 39 257 146 
41 277 190 149 139 25 55 329 
239 310 24 113 8 231 51 16 
303 177 292 84 260 137 331 174 
69 92 282 7 142 172 80 63 
211 70 106 334 293 23 101 298 
225 274 246 296 306 152 328 166 
333 40 217 168 319 68 307 0 
56 189 147 17 74 267 250 98 
228 327 256 179 294 31 82 121 
196 193 72 188 42 91 199 124 
203 132 128 156 266 96 126 182 
263 287 243 35 264 22 224 151 
111 288 138 314 164 114 230 185 
202 86 216 255 61 66 170 244 
258 34 236 110 316 47 253 325 
133 206 192 180 155 245 301 269 
284 261 289 270 122 135 21 297 
89 268 15 235 254 20 3 36 
248 322 115 191 308 12 131 265 
291 103 311 29 330 304 78 215 
144 208 321 205 194 295 38 119 
13 95 259 129 46 181 19 58 
286 11 87 213 315 79 88 247 
2 312 161 232 226 318 326 302 
309 320 125 280 65 73 93 76 
158 278 218 85 162 57 123 279 
145 252 299 207 175 271 18 50 
305 112 9 273 163 118 37 71 
178 136 275 184 285 169 153 141 
64 148 102 6 75 10 100 4 
67 323 49 154 176 32 240 81 
14 28 62 332 160 26 30 227 
43 127 45 241 120 229 276 238 
313 99 83 157 214 233 150 187 
171 48 27 186 249 143 44 134 
234 130 53 209 212 290 140 324 
54 281 272 204 94 90 52 300 
198 167 165 210 221 223 108 97 
262 283 222 33 201 117 104 159 
109 195 60 173 200 220 219 237 
