227 202 19 458 363 326 374 289 312 313 
317 121 45 349 518 6 132 213 43 328 
73 195 95 406 141 193 31 255 367 76 
163 318 516 3 203 277 476 472 100 348 
451 485 156 325 435 359 381 355 252 288 
455 88 399 304 369 188 493 36 230 142 
473 462 368 178 225 402 334 480 296 429 
249 454 11 130 171 170 183 437 360 259 
23 271 465 257 489 137 377 63 158 115 
244 453 391 251 78 66 320 358 99 376 
153 65 34 362 13 301 72 324 440 250 
343 50 323 307 442 17 25 284 83 394 
58 353 232 339 370 388 478 382 392 507 
290 87 93 430 82 138 356 417 62 74 
125 152 172 221 54 460 396 192 466 286 
431 123 410 162 59 506 383 131 150 471 
350 189 204 71 469 69 89 387 428 97 
134 186 335 314 463 272 206 449 322 487 
22 41 384 481 519 239 483 421 92 129 
393 53 310 117 398 357 426 419 275 450 
424 191 373 422 477 64 248 409 52 265 
492 157 273 474 292 276 468 327 197 29 
338 415 5 7 217 347 223 305 167 346 
405 28 332 499 149 379 464 488 208 269 
165 179 79 404 174 4 33 412 15 80 
267 77 84 48 51 247 283 207 231 407 
299 47 70 10 515 443 184 124 220 501 
1 503 32 371 145 333 144 502 68 86 
169 240 395 291 216 294 268 351 246 309 
403 490 120 214 461 457 514 27 154 512 
300 311 211 364 390 160 237 400 262 420 
427 264 456 113 297 509 177 148 511 401 
413 425 55 151 520 306 433 441 133 198 
329 378 321 253 18 508 236 298 2 354 
140 42 136 61 386 263 122 194 105 416 
159 495 496 49 504 432 209 389 8 164 
35 106 517 408 479 224 127 228 337 212 
510 104 285 316 85 185 102 444 330 143 
101 438 500 135 161 411 261 494 448 60 
196 342 12 91 173 452 111 147 14 341 
146 96 229 467 315 218 110 308 108 210 
336 44 344 20 258 176 37 279 372 361 
200 375 126 40 352 243 302 491 245 168 
303 181 57 90 278 521 199 114 128 238 
282 340 201 365 94 331 497 103 254 234 
459 56 26 39 260 24 470 30 319 446 
484 242 445 397 21 345 139 215 180 235 
434 418 498 222 241 190 226 266 166 16 
287 46 447 116 505 423 293 295 107 98 
175 233 9 0 256 182 385 118 414 436 
155 187 281 75 119 366 439 38 475 270 
280 109 205 380 219 274 112 81 67 482 
